(((())))()((((((((())()(()))(()((((()(()(((()((()((()(()()()()()))(((()(()((((((((((())(()()((())()(((())))()(()(()((()(()))(()()()()((()((()(
((()()(((((((()()())()((((()()(((((()(())()(())((())()()))()(((((((())(()())(()(((())(()))((())))(()((()())))()())((((())))(()(((((()(())(((()
()((()((()((((((((((())(()())))))()))())()()((((()()()()()()((((((())())(((()())()((()()(((()()()))(((((()))(((()(()()()(()(()(((())()))(()(((
()((())()(()())())))((()()()(()()(((()))(((()((((()(((((()()(()())((()())())(()((((((()(()()))((((()))))())((())()()((()(()))))((((((((()))(()
()(((())())(())()((()()()()((()((()((()()(((())))(()((())()((((((((()((()(()()(((())())())))(())())))()((((()))))))())))()()))()())((()())()((
()()()))(()()(((()(())((((())())((((((((()()()()())))()()()((((()()))))))()((((()(((()))(()()())))((()()(((()))()()())())(((())((()()(())()()(
)(((())))))()())((()))()))((())()()())()())()()(()))())))())()))(())((()(())))(()(())(()))))(()(())())(()(())(()(()))))((()())()))()((((()()))
))())))()()())((())()((()()()))()(((()(()))))(())()()))(((()())))))))))(((())))()))())()))))()()(((())))))))()(()()(()))((()))))((())))((()(((
))))())))()()(()))())()(()((()())(()(()()())())(()()))()))))(()())()()))()()()()))(()(()(()))))))()(()))()))()()(()((())(()(())))()(((())(())(
))))))()(()(()))))()))(()()()(())()(()(())))()))))()()(((((())))))())()())())())()())()))))()))))))))())()()()()()()())))()))((())()))())))()(
(())()))))()))())))))))())()()()))()()(()((((()(((((((()(())((()())((()()))()))))(())))()()()(())((())()())))(())))(())))(((()()))()(())(((()(
()))((())))())()))((((()))())()))))))))()(())())))(()))()(()()))())()()(())())))())()()(()())))()((()())(()(())(())))))))))))))(()))))()))))))
()()())(()(((((()(()())))())()))(()))()))(()()))()())(()))())()(())((()()))))))())))())()(((())))(()(()))()()))()(()))))))((()())(()))))))()()
)))()()))))))))((((((((()()()(()))))))()())))())))()()((())()))((())(())))())())))()()()((()((()(())))())()(())))))))))()())))()()()()()()))()
))((())())(()(()))))))(()()))()))(())))()))))))))))))(()))))))))()))))()))()())()))()()))))))()))))((()))))(()))())()(())))(()())((((()())))()
))))(()))()(()()(())))))())))))()))))))())))())))))())))())())))())(()))))(())()(())))())()))((()()))))))())))((())))))))())))(())))))()()()))
)))())))))()))))))()))()()()(()(((()())())())(()))())))))((()(())(()))))))))(())))()()()())())(()))))()()()))()))())())())()(())))()(((()(((((
))))))))()))))))))))))))))))))((())()())(()))))()()))))))(()()(())())))())))((())))((())))))))))))))()))))()(()))))))())))))()))(()()())(()())
))))))))()))))))(())))))()()))()())(((())))()))(()))))))))(())())))())))())())())()()))((())()(())()())()))()())(())(()))))()())))(()(((()))))
))()(()())()()()))()))))))))()()()(())()())()(((((()))()())())(()))))()()()(())))())))()((()())))(()))())()(()())())(()))()()))((()()))((()()(
)()())))(())()))(()(())))((()()))))))))())))))))())()()))))))))))))))))(())()(())(())()())())()))()(()))))())())))))()())()(()))()()(())))(())
())))))(()))))))))))))))())())(())(())))(((()))()))))())((())(()))())))))))())))))())))()))()))))))))))))())()))))()))))((()))(())))()(())))((
))()))()))())))())))))))()(()())())))()()())))(())))))(()))))))))))))(()))()))()))())))(((()()()(())((()())))()())(((()))(())()))((()()()())))
())(())(()))))()(((((())))(()))())())))))))((((()()()))())())()(()(()())))))))))()())())))(())))()())(((()(())())()()))())())))))))((()())((()
()(()))(()(())))()))()))(()))(()))()()(()(((())((((()))()(()))((())()(()(()())()(()))()())))))(()))()))())()())))())))(())))((())(()())))))())
)(())(()))()())()(()()((()(()))))))()(())(()())(())()))(((())()))(()()(()()()))))(()(())))()))))())))))())(()()()()()()(((())))(()()))()((())(
((((()()())))(()))(()))()()))(((())())()(((()()()()))))(()))(())())))()())(()()())())))))))()))))((())))()())(()))(()(()))())))))())(())))))()
()())())()))()()(())))(()))(())((((((())(()))(()))())()))(()()(())))()))(()()))()))()(())))(())))((()(()))(())()()())())))(((()()())(())()))))
))()(((()(((((()()(((())(())))())()((()))))((()())()(())(((())))(((()((()(()(()))(()()))())(()))(())(())))()))))))((((()))()((((()(()))()))()(
)))))()(()(()))()(()((()(((()(()()(((()))))()(((()(()(()(((()(()())())()()(()(()())())(()((((())(()))()))(((((()()())(())()((()()())))()()((((
)()))()((((((((()(())))())((()))))(())))(()))))((()((((()()(())(((((()))(((((((((((((()())))((((()(((()((())())()))((()))()(()()((()()()()(()(
)(()(()(((())()(()((((((()((()()((())()((((()((()()(()()())((()()()((()((())()(()(((()((())((((())(()))((()(()))(()())()((((((((()((((((((((((
)))(()(((()(()()()((((())((())()())()))(())((())(()))(((()((()(())))(()))))((()()))))((((()(()(()())(()(())((((((((()((((()((()(((((()))())()(
()))(()()((()(())(((((()(())()(((((()()))))))()(((())()(()()((((())()((())((()(((())(((()))((()()((((()(())))))((()((((()((()((()(((())((()))(
((((((()(((()((((((((())()))((((())(((((()((((((((()(((()((()(((()()(((()((((((()()(()((((((((()()(()(()(())((((()())()))))(((()))((((())(((((
)())((()(())()((()((((((()((((((()(())))()())(((())())())()(())()(()())((()()((((())((((((())(()(((((()((((())()((((()(()(())(()())(((())()(((
))((((()))()((((((())(()(((()(((()((((((()(((()))(()()())())((()((()())()((((())(((()(()(((((((((())(())))()((()()()()(())((()))(((((((()(((((
((((()(()))))(()((((((((()((((()((()()((((((()()(((((((()(()(())()(())((()()()((()(((((()())()(((((()())()()((()(()())(()()()(((()()(((((()(((
(((()()((()(()()()((((((((((((()((((((((()()(((()())))()(((()()(())())((((()((((()((((()()()(())(())((()(()(((((((((((((((()(())(())))))()()))
((()(((()(())((()(((()(()()((((()()(((()(((()(((((()()((()(()(((()))((((((()((((((((()((()((())(((((()(((())(())())((()()))((((())()()((()((((
)(((((()()(((()))(((()(()(((((((((((((()))((((((((()(((()))))())((((((((((((())((())((()())(((())((())(()((((((((((()(((())((()()(()((())(((((
((((((()))((((((((((((()(()())((()((()((()(()(((()((((((((()()(()((()(()(((()))((()))(((((((((((((()(())((((((())(((()(())(()(()(()((()()))(((
(()((((()((((())))())((((()((((()))((((((()((((((()((()(((())))((())(()))(()((()((((()((()(((()()))((((()()()(((((((())(((())(()))())((((()())
(((()(((((((((((()(()(()((()(((((((((((((((()()((((()((((((((()(((()()((()((((()))(((()(())((((((()((((())()((((()((()))(())()(()(((()((())())
((((((()(()(())())(((())(()(()())(((((()((()((())()())(())))(((()(())))))))(((()(((()))()((()(((()()((()())()()))())))(((()))(()(((()(((((((((
()(()(((((()()(((()())()()))))()(((()))(((()(()(()(()(()))()(())()))(()(((())))(()))))))))))(())((()((())((()(())()(())((()()((((()()((()()))(
(())(((()((()(())(())))()(()(((((()((()))())()(((((()()(((()(()((((((())(()))(())()))((()(()()))(())())()))(((())))(()((()(((())(())())))((()(
)((((((((((((((()((()(()()(()(((()))())()()((()()()(())(()))(()())(((())((())()(())()()(()()(())))((()(((()))))(((()()(()()))())((()((())()))(
(((()()()())((())))(((()(())(((((()(((((()((()(()((((()()(((()()()(((()())(((()()((((())(()))(((()))(())())((()))(((()((()))(((()()((())((()((
(((()((((()()())((()))()((((()((()(()()()(